{
    "m_row":9,
    "m_col":9,
    "m_cells":[
                1,1,1,1,1,1,1,0,0,
                0,1,1,1,1,1,1,1,0,
                1,1,1,0,0,0,1,1,1,
                1,1,1,1,1,1,1,1,1,
                1,1,1,0,0,0,1,1,1,
                1,1,1,0,0,0,1,1,1,
                1,1,1,1,1,1,1,1,1,
                1,1,1,1,1,1,1,1,1,
                1,1,1,1,1,1,1,1,1
             ]
}